F 185,180, 171

NO ./xpm/xpm/blue-wall.xpm

EA ./xpm/xpm/banner.xpm

SO ./xpm/xpm/grey-slab-wall.xpm

WE ./xpm/xpm/red-wall.xpm

C 135,206,250

        1111111111111111111111111
        1000000000110000000000101
        10110000011100000000S0101
        1001000000000000000000001
111111111011000001110000000000001
100000000011000001110100111111111
11111111121111111111110011111
        101   1   1011001
11111111101111011111110011111
10000000000000001100000000001
10000000000000001101010000001
1100000111010101111101101121111
11110111 1110101 10111010001
11111111 1111111 111111111111

